#######################
#      #       #      #
#              # x #  #
#     #####    #####  #
#         #           #
######    ##  #####   #
#          #     #    #
#     ###        #    #
#       #####    #    #
#     s #   #    #    #
#           #   ###   #
#       #####         #
#                #    #
#######################