############
#s         #
# #######  #
# #    ##  #
# #        #
# #  #######
# #        #
########## #
#  x       #
############
