#########
#s#   #x#
# # # # #
# # # # #
#   #   #
#########