#########
#s99999x#
# 22222 #
#       #
#########